0. Повторение
1. Местоимения
       | единственное | множественное |
       |     число    |     число     |
-------+--------------+---------------+
первое |       mi     |      ni       |
 лицо  |              |               |
-------+--------------+---------------+
второе |             vi               |
 лицо  |                              |
-------+--------------+---------------+
третье |   li + ŝi    |     ili       |
 лицо  |   ĝi (tio)   |               |
       |            oni               |
       |             si	              |
-------+--------------+----------------
mi - я
 mi estis feliĉa - я был счастлив
ni - мы, т.е. группа из говорящего и ещё минимум одного человека
 ni estas programistoj - мы — програмисты
vi - вы (от одного до плюс бесконечности)
 vi estas rapida - ты (вы) быстрый(быстрая). речь идёт об одном человеке
Не забывайте о том, что множественное число vi требует правильного окончания у прилагательных:
 vi estas rapidaj - вы быстрые
li - он. кроме того, человек неопределённого пола
 li estas granda - он (человек) большой
ŝi - она
 ŝi estas juna - она молода
Деление по родам бывает только у людей. Все остальные предметы, животные, растения и явления - среднего рода.
ĝi - оно
 ĝi estas granda - оно (он, она) большое (большой, большая)
tio - то же, но относительно обстрактных понятий
ili - они (определённое местоимение). Множество знакомых предметов или людей
 ili estas malgrandaj programistoj - они — маленькие программисты
oni - абстрактное "все люди", "говорят", "каждый"
si - специфичное местоимение третьего лица, может быть множественного или единственного числа (от контекста)
 Li lavas lin - он моет его (второй он — другая персона)
 li lavas sin - он умывается

Притяжательные местоимения создаются окончанием -a:
 mia kato
 via hundoj

2. Новые существительные:
 domo - дом
 tegmento - крыша
 ĉambro - комната
 plafono - потолок
 planko - пол
 pordo - дверь
 tablo - стол
 seĝo - стул
 programisto - программист
 filo - сын

3. Новые прилагательные:
 nova - новый (новая)
 longa - длинный (длинная)
 larĝa - широкий (широкая)
 seka - сухой (сухая)
 plena - полный (полная)
Как и в остальных случаях, приставка mal- удваивает ваш словарный запас:
 malnova - старый (в смысле как "старый стул", иначе maljuna) 
 mallonga - короткий
 mallarĝa - узкий
 malseka - мокрый
 malplena - пустой

4. Глаголы:
 lavi - мыться
 ami - любить
 havi - иметь

Примеры:
 La doma estas nova. - Новый дом.
 Ŝi estas nia nova programisto. - Она — наша новая програмистка.
 Mi amis vin. - Я вас любил
 Li lavis la filon. - Он умывал(купал) сына.

5. Предлоги:
 en - в
  la hundo estis en la domo - собака была в доме
 sur - на
  la kato estas sur la tbalo ĉar la hundo estas en la domo - кот на столе потому что собака в доме
 super - над
  la plafono estas sur la planko - потолок над полом
 sub - под
  la hundo estis sub la seĝo - собака была под стулом
 antaŭ - перед
  la kato estis antaŭ la pordo - кот был перед дверью
 malantaŭ - за (чем-то)
  la knabo estas malantaŭ la tablo - мальчик за столом
 inter - между
  la knabino estis inter la viro kaj la virino - девочка находилась между мужчиной и женщиной
 apud - возле
  lamalseka hundo estis apud la filo - мокрый собака рядом с сыном
